0 0 0 0 0 0 0 0 0 0 0 0 0
1 1 1 1 1 0 1 1 1 1 1 1 1
1 7 1 1 1 0 1 1 1 7 0 0 1
1 0 1 5 1 0 1 1 1 1 1 1 1
2 0 2 2 2 0 2 2 2 2 2 2 2
2 0 2 2 2 0 2 2 2 2 2 2 2
2 2 2 2 0 8 0 2 2 2 2 2 2
3 3 3 3 3 3 3 3 0 3 3 3 3
3 0 0 0 7 3 3 3 0 5 3 3 3
3 3 3 3 3 3 3 3 0 3 3 3 3
4 4 5 4 4 4 4 4 0 4 4 4 4
4 4 4 4 4 4 4 4 7 4 4 4 4
4 4 4 4 4 4 4 4 4 4 4 4 4